@............
#..........#.
#.......####.
#...#.###..#.
###...#...##.
.######...##.
.###.......#*
