@............
.............
##.#.........
#......#..#..
...#...##..#.
..#..#....###
...#.#....##*
